E-G-G-O-O-
----------
-G-B-M-O-O
----------
E-F-G-I-G-
----------
-D-G-F-B-G
----------
O-O-B-G-G-
----------

