G-G-D-O-O-
----------
-E-B-G-O-O
----------
G-D-G-M-G-
----------
-B-B-F-G-F
----------
I-G-G-D-G-
----------

