G-G-G-O-O-
----------
-F-B-G-O-O
----------
G-G-G-M-G-
----------
-B-B-F-G-F
----------
I-G-G-G-G-
----------

