G-G-G-O-O-
----------
-G-B-M-O-O
----------
G-F-G-I-G-
----------
-G-G-F-B-F
----------
G-G-B-G-G-
----------

